000000000000000000000000000000000000000000000000000000000000
000000002222200000000000000000000000002222200000000000000000
000000000000000000000222200000000000000000000000000222200000
000000000000000000000111100000000000000000000000000111100000
000000022222000000000000000000000000022222000000000000000000
000000000000000000000000000000000000000000000000000000000000
220000000000000002200000022000220000000000000002200000022000
112222222222222221100002211200112220000222222221100002211200
111111111111111111100001111100111110000111111111100001111100
111111111111111111100000110000111111110000111111100000110000
111111111111111111111111111111111111000001111111100000100000
111111111111111111111111111111111111111111111111100000100000
111111111111111111111111111111111111111111111111100000000000